# Data from Minecraft Wiki @ https://minecraft.fandom.com/wiki/Biome#Biome_IDs
# Select *all* table data cells to clone info.

 The Void	the_void	0
 Plains	plains	1
 Sunflower Plains	sunflower_plains	2
 Snowy Plains	snowy_plains	3
 Ice Spikes	ice_spikes	4
 Desert	desert	5
 Swamp	swamp	6
 Mangrove Swamp	mangrove_swamp	7
 Forest	forest	8
 Flower Forest	flower_forest	9
 Birch Forest	birch_forest	10
 Dark Forest	dark_forest	11
 Old Growth Birch Forest	old_growth_birch_forest	12
 Old Growth Pine Taiga	old_growth_pine_taiga	13
 Old Growth Spruce Taiga	old_growth_spruce_taiga	14
 Taiga	taiga	15
 Snowy Taiga	snowy_taiga	16
 Savanna	savanna	17
 Savanna Plateau	savanna_plateau	18
 Windswept Hills	windswept_hills	19
 Windswept Gravelly Hills	windswept_gravelly_hills	20
 Windswept Forest	windswept_forest	21
 Windswept Savanna	windswept_savanna	22
 Jungle	jungle	23
 Sparse Jungle	sparse_jungle	24
 Bamboo Jungle	bamboo_jungle	25
 Badlands	badlands	26
 Eroded Badlands	eroded_badlands	27
 Wooded Badlands	wooded_badlands	28
 Meadow	meadow	29
 Cherry Grove	cherry_grove	30
 Grove	grove	31
 Snowy Slopes	snowy_slopes	32
 Frozen Peaks	frozen_peaks	33
 Jagged Peaks	jagged_peaks	34
 Stony Peaks	stony_peaks	35
 River	river	36
 Frozen River	frozen_river	37
 Beach	beach	38
 Snowy Beach	snowy_beach	39
 Stony Shore	stony_shore	40
 Warm Ocean	warm_ocean	41
 Lukewarm Ocean	lukewarm_ocean	42
 Deep Lukewarm Ocean	deep_lukewarm_ocean	43
 Ocean	ocean	44
 Deep Ocean	deep_ocean	45
 Cold Ocean	cold_ocean	46
 Deep Cold Ocean	deep_cold_ocean	47
 Frozen Ocean	frozen_ocean	48
 Deep Frozen Ocean	deep_frozen_ocean	49
 Mushroom Fields	mushroom_fields	50
 Dripstone Caves	dripstone_caves	51
 Lush Caves	lush_caves	52
 Deep Dark	deep_dark	53
 Nether Wastes	nether_wastes	54
 Warped Forest	warped_forest	55
 Crimson Forest	crimson_forest	56
 Soul Sand Valley	soul_sand_valley	57
 Basalt Deltas	basalt_deltas	58
 The End	the_end	59
 End Highlands	end_highlands	60
 End Midlands	end_midlands	61
 Small End Islands	small_end_islands	62
 End Barrens	end_barrens	63
