# Data from Minecraft Wiki @ https://minecraft.fandom.com/wiki/Java_Edition_data_values#Blocks
# Select *all* table data cells to clone info.

Acacia Button	acacia_button	Acacia Button	Identical
Acacia Door	acacia_door	Acacia Door	Identical
Acacia Fence	acacia_fence	Acacia Fence	Identical
Acacia Fence Gate	acacia_fence_gate	Acacia Fence Gate	Identical
Acacia Leaves	acacia_leaves	Acacia Leaves	Identical
Acacia Log	acacia_log	Acacia Log	Identical
Acacia Planks	acacia_planks	Acacia Planks	Identical
Acacia Pressure Plate	acacia_pressure_plate	Acacia Pressure Plate	Identical
Acacia Sapling	acacia_sapling	Acacia Sapling	Identical
Acacia Sign	acacia_sign	Acacia Sign	Identical
Acacia Slab	acacia_slab	Acacia Slab	Identical
Acacia Stairs	acacia_stairs	Acacia Stairs	Identical
Acacia Trapdoor	acacia_trapdoor	Acacia Trapdoor	Identical
Acacia Wall Sign	acacia_wall_sign	Acacia Wall Sign	acacia_sign
Acacia Wood	acacia_wood	Acacia Wood	Identical
Activator Rail	activator_rail	Activator Rail	Identical
Air	air	Air	Identical
Allium	allium	Allium	Identical
Block of Amethyst	amethyst_block	Block of Amethyst	Identical
Amethyst Cluster	amethyst_cluster	Amethyst Cluster	Identical
Ancient Debris	ancient_debris	Ancient Debris	Identical
Andesite	andesite	Andesite	Identical
Andesite Slab	andesite_slab	Andesite Slab	Identical
Andesite Stairs	andesite_stairs	Andesite Stairs	Identical
Andesite Wall	andesite_wall	Andesite Wall	Identical
Anvil	anvil	Anvil	Identical
Attached Melon Stem	attached_melon_stem	Attached Melon Stem	melon_seeds
Attached Pumpkin Stem	attached_pumpkin_stem	Attached Pumpkin Stem	pumpkin_seeds
Azalea	azalea	Azalea	Identical
Azalea Leaves	azalea_leaves	Azalea Leaves	Identical
Azure Bluet	azure_bluet	Azure Bluet	Identical
Bamboo	bamboo	Bamboo	Identical
Bamboo Shoot	bamboo_sapling	Bamboo Shoot	bamboo
Barrel	barrel	Barrel	Identical
Barrier	barrier	Barrier	Identical
Basalt	basalt	Basalt	Identical
Beacon	beacon	Beacon	Identical
Bedrock	bedrock	Bedrock	Identical
Bee Nest	bee_nest	Bee Nest	Identical
Beehive	beehive	Beehive	Identical
Beetroots	beetroots	Beetroots	beetroot_seeds
Bell	bell	Bell	Identical
Big Dripleaf	big_dripleaf	Big Dripleaf	Identical
Big Dripleaf Stem	big_dripleaf_stem	Big Dripleaf Stem	big_dripleaf
Birch Button	birch_button	Birch Button	Identical
Birch Door	birch_door	Birch Door	Identical
Birch Fence	birch_fence	Birch Fence	Identical
Birch Fence Gate	birch_fence_gate	Birch Fence Gate	Identical
Birch Leaves	birch_leaves	Birch Leaves	Identical
Birch Log	birch_log	Birch Log	Identical
Birch Planks	birch_planks	Birch Planks	Identical
Birch Pressure Plate	birch_pressure_plate	Birch Pressure Plate	Identical
Birch Sapling	birch_sapling	Birch Sapling	Identical
Birch Sign	birch_sign	Birch Sign	Identical
Birch Slab	birch_slab	Birch Slab	Identical
Birch Stairs	birch_stairs	Birch Stairs	Identical
Birch Trapdoor	birch_trapdoor	Birch Trapdoor	Identical
Birch Wall Sign	birch_wall_sign	Birch Wall Sign	birch_sign
Birch Wood	birch_wood	Birch Wood	Identical
Black Banner	black_banner	Black Banner	Identical
Black Bed	black_bed	Black Bed	Identical
Black Candle	black_candle	Black Candle	Identical
Cake with Black Candle	black_candle_cake	Cake with Black Candle	cake
Black Carpet	black_carpet	Black Carpet	Identical
Black Concrete	black_concrete	Black Concrete	Identical
Black Concrete Powder	black_concrete_powder	Black Concrete Powder	Identical
Black Glazed Terracotta	black_glazed_terracotta	Black Glazed Terracotta	Identical
Black Shulker Box	black_shulker_box	Black Shulker Box	Identical
Black Stained Glass	black_stained_glass	Black Stained Glass	Identical
Black Stained Glass Pane	black_stained_glass_pane	Black Stained Glass Pane	Identical
Black Terracotta	black_terracotta	Black Terracotta	Identical
Black Wall Banner	black_wall_banner	Black Wall Banner	black_banner
Black Wool	black_wool	Black Wool	Identical
Blackstone	blackstone	Blackstone	Identical
Blackstone Slab	blackstone_slab	Blackstone Slab	Identical
Blackstone Stairs	blackstone_stairs	Blackstone Stairs	Identical
Blackstone Wall	blackstone_wall	Blackstone Wall	Identical
Blast Furnace	blast_furnace	Blast Furnace	Identical
Blue Banner	blue_banner	Blue Banner	Identical
Blue Bed	blue_bed	Blue Bed	Identical
Blue Candle	blue_candle	Blue Candle	Identical
Cake with Blue Candle	blue_candle_cake	Cake with Blue Candle	cake
Blue Carpet	blue_carpet	Blue Carpet	Identical
Blue Concrete	blue_concrete	Blue Concrete	Identical
Blue Concrete Powder	blue_concrete_powder	Blue Concrete Powder	Identical
Blue Glazed Terracotta	blue_glazed_terracotta	Blue Glazed Terracotta	Identical
Blue Ice	blue_ice	Blue Ice	Identical
Blue Orchid	blue_orchid	Blue Orchid	Identical
Blue Shulker Box	blue_shulker_box	Blue Shulker Box	Identical
Blue Stained Glass	blue_stained_glass	Blue Stained Glass	Identical
Blue Stained Glass Pane	blue_stained_glass_pane	Blue Stained Glass Pane	Identical
Blue Terracotta	blue_terracotta	Blue Terracotta	Identical
Blue Wall Banner	blue_wall_banner	Blue Wall Banner	blue_banner
Blue Wool	blue_wool	Blue Wool	Identical
Bone Block	bone_block	Bone Block	Identical
Bookshelf	bookshelf	Bookshelf	Identical
Brain Coral	brain_coral	Brain Coral	Identical
Brain Coral Block	brain_coral_block	Brain Coral Block	Identical
Brain Coral Fan	brain_coral_fan	Brain Coral Fan	Identical
Brain Coral Wall Fan	brain_coral_wall_fan	Brain Coral Wall Fan	brain_coral_fan
Brewing Stand	brewing_stand	Brewing Stand	Identical
Brick Slab	brick_slab	Brick Slab	Identical
Brick Stairs	brick_stairs	Brick Stairs	Identical
Brick Wall	brick_wall	Brick Wall	Identical
Bricks	bricks	Bricks	Identical
Brown Banner	brown_banner	Brown Banner	Identical
Brown Bed	brown_bed	Brown Bed	Identical
Brown Candle	brown_candle	Brown Candle	Identical
Cake with Brown Candle	brown_candle_cake	Cake with Brown Candle	cake
Brown Carpet	brown_carpet	Brown Carpet	Identical
Brown Concrete	brown_concrete	Brown Concrete	Identical
Brown Concrete Powder	brown_concrete_powder	Brown Concrete Powder	Identical
Brown Glazed Terracotta	brown_glazed_terracotta	Brown Glazed Terracotta	Identical
Brown Mushroom	brown_mushroom	Brown Mushroom	Identical
Brown Mushroom Block	brown_mushroom_block	Brown Mushroom Block	Identical
Brown Shulker Box	brown_shulker_box	Brown Shulker Box	Identical
Brown Stained Glass	brown_stained_glass	Brown Stained Glass	Identical
Brown Stained Glass Pane	brown_stained_glass_pane	Brown Stained Glass Pane	Identical
Brown Terracotta	brown_terracotta	Brown Terracotta	Identical
Brown Wall Banner	brown_wall_banner	Brown Wall Banner	brown_banner
Brown Wool	brown_wool	Brown Wool	Identical
Bubble Column	bubble_column	Bubble Column	None
Bubble Coral	bubble_coral	Bubble Coral	Identical
Bubble Coral Block	bubble_coral_block	Bubble Coral Block	Identical
Bubble Coral Fan	bubble_coral_fan	Bubble Coral Fan	Identical
Bubble Coral Wall Fan	bubble_coral_wall_fan	Bubble Coral Wall Fan	bubble_coral_fan
Budding Amethyst	budding_amethyst	Budding Amethyst	Identical
Cactus	cactus	Cactus	Identical
Cake	cake	Cake	Identical
Calcite	calcite	Calcite	Identical
Campfire	campfire	Campfire	Identical
Candle	candle	Candle	Identical
Cake with Candle	candle_cake	Cake with Candle	cake
Carrots	carrots	Carrots	carrot
Cartography Table	cartography_table	Cartography Table	Identical
Carved Pumpkin	carved_pumpkin	Carved Pumpkin	Identical
Cauldron	cauldron	Cauldron	Identical
Cave Air	cave_air	Cave Air	None
Cave Vines	cave_vines	Cave Vines	glow_berries
Cave Vines Plant	cave_vines_plant	Cave Vines Plant	glow_berries
Chain	chain	Chain	Identical
Chain Command Block	chain_command_block	Chain Command Block	Identical
Chest	chest	Chest	Identical
Chipped Anvil	chipped_anvil	Chipped Anvil	Identical
Chiseled Deepslate	chiseled_deepslate	Chiseled Deepslate	Identical
Chiseled Nether Bricks	chiseled_nether_bricks	Chiseled Nether Bricks	Identical
Chiseled Polished Blackstone	chiseled_polished_blackstone	Chiseled Polished Blackstone	Identical
Chiseled Quartz Block	chiseled_quartz_block	Chiseled Quartz Block	Identical
Chiseled Red Sandstone	chiseled_red_sandstone	Chiseled Red Sandstone	Identical
Chiseled Sandstone	chiseled_sandstone	Chiseled Sandstone	Identical
Chiseled Stone Bricks	chiseled_stone_bricks	Chiseled Stone Bricks	Identical
Chorus Flower	chorus_flower	Chorus Flower	Identical
Chorus Plant	chorus_plant	Chorus Plant	Identical
Clay	clay	Clay	Identical
Block of Coal	coal_block	Block of Coal	Identical
Coal Ore	coal_ore	Coal Ore	Identical
Coarse Dirt	coarse_dirt	Coarse Dirt	Identical
Cobbled Deepslate	cobbled_deepslate	Cobbled Deepslate	Identical
Cobbled Deepslate Slab	cobbled_deepslate_slab	Cobbled Deepslate Slab	Identical
Cobbled Deepslate Stairs	cobbled_deepslate_stairs	Cobbled Deepslate Stairs	Identical
Cobbled Deepslate Wall	cobbled_deepslate_wall	Cobbled Deepslate Wall	Identical
Cobblestone	cobblestone	Cobblestone	Identical
Cobblestone Slab	cobblestone_slab	Cobblestone Slab	Identical
Cobblestone Stairs	cobblestone_stairs	Cobblestone Stairs	Identical
Cobblestone Wall	cobblestone_wall	Cobblestone Wall	Identical
Cobweb	cobweb	Cobweb	Identical
Cocoa	cocoa	Cocoa	cocoa_beans
Command Block	command_block	Command Block	Identical
Redstone Comparator	comparator	Redstone Comparator	Identical
Composter	composter	Composter	Identical
Conduit	conduit	Conduit	Identical
Block of Copper	copper_block	Block of Copper	Identical
Copper Ore	copper_ore	Copper Ore	Identical
Cornflower	cornflower	Cornflower	Identical
Cracked Deepslate Bricks	cracked_deepslate_bricks	Cracked Deepslate Bricks	Identical
Cracked Deepslate Tiles	cracked_deepslate_tiles	Cracked Deepslate Tiles	Identical
Cracked Nether Bricks	cracked_nether_bricks	Cracked Nether Bricks	Identical
Cracked Polished Blackstone Bricks	cracked_polished_blackstone_bricks	Cracked Polished Blackstone Bricks	Identical
Cracked Stone Bricks	cracked_stone_bricks	Cracked Stone Bricks	Identical
Crafting Table	crafting_table	Crafting Table	Identical
Creeper Head	creeper_head	Creeper Head	Identical
Creeper Wall Head	creeper_wall_head	Creeper Wall Head	creeper_head
Crimson Button	crimson_button	Crimson Button	Identical
Crimson Door	crimson_door	Crimson Door	Identical
Crimson Fence	crimson_fence	Crimson Fence	Identical
Crimson Fence Gate	crimson_fence_gate	Crimson Fence Gate	Identical
Crimson Fungus	crimson_fungus	Crimson Fungus	Identical
Crimson Hyphae	crimson_hyphae	Crimson Hyphae	Identical
Crimson Nylium	crimson_nylium	Crimson Nylium	Identical
Crimson Planks	crimson_planks	Crimson Planks	Identical
Crimson Pressure Plate	crimson_pressure_plate	Crimson Pressure Plate	Identical
Crimson Roots	crimson_roots	Crimson Roots	Identical
Crimson Sign	crimson_sign	Crimson Sign	Identical
Crimson Slab	crimson_slab	Crimson Slab	Identical
Crimson Stairs	crimson_stairs	Crimson Stairs	Identical
Crimson Stem	crimson_stem	Crimson Stem	Identical
Crimson Trapdoor	crimson_trapdoor	Crimson Trapdoor	Identical
Crimson Wall Sign	crimson_wall_sign	Crimson Wall Sign	crimson_sign
Crying Obsidian	crying_obsidian	Crying Obsidian	Identical
Cut Copper	cut_copper	Cut Copper	Identical
Cut Copper Slab	cut_copper_slab	Cut Copper Slab	Identical
Cut Copper Stairs	cut_copper_stairs	Cut Copper Stairs	Identical
Cut Red Sandstone	cut_red_sandstone	Cut Red Sandstone	Identical
Cut Red Sandstone Slab	cut_red_sandstone_slab	Cut Red Sandstone Slab	Identical
Cut Sandstone	cut_sandstone	Cut Sandstone	Identical
Cut Sandstone Slab	cut_sandstone_slab	Cut Sandstone Slab	Identical
Cyan Banner	cyan_banner	Cyan Banner	Identical
Cyan Bed	cyan_bed	Cyan Bed	Identical
Cyan Candle	cyan_candle	Cyan Candle	Identical
Cake with Cyan Candle	cyan_candle_cake	Cake with Cyan Candle	cake
Cyan Carpet	cyan_carpet	Cyan Carpet	Identical
Cyan Concrete	cyan_concrete	Cyan Concrete	Identical
Cyan Concrete Powder	cyan_concrete_powder	Cyan Concrete Powder	Identical
Cyan Glazed Terracotta	cyan_glazed_terracotta	Cyan Glazed Terracotta	Identical
Cyan Shulker Box	cyan_shulker_box	Cyan Shulker Box	Identical
Cyan Stained Glass	cyan_stained_glass	Cyan Stained Glass	Identical
Cyan Stained Glass Pane	cyan_stained_glass_pane	Cyan Stained Glass Pane	Identical
Cyan Terracotta	cyan_terracotta	Cyan Terracotta	Identical
Cyan Wall Banner	cyan_wall_banner	Cyan Wall Banner	cyan_banner
Cyan Wool	cyan_wool	Cyan Wool	Identical
Damaged Anvil	damaged_anvil	Damaged Anvil	Identical
Dandelion	dandelion	Dandelion	Identical
Dark Oak Button	dark_oak_button	Dark Oak Button	Identical
Dark Oak Door	dark_oak_door	Dark Oak Door	Identical
Dark Oak Fence	dark_oak_fence	Dark Oak Fence	Identical
Dark Oak Fence Gate	dark_oak_fence_gate	Dark Oak Fence Gate	Identical
Dark Oak Leaves	dark_oak_leaves	Dark Oak Leaves	Identical
Dark Oak Log	dark_oak_log	Dark Oak Log	Identical
Dark Oak Planks	dark_oak_planks	Dark Oak Planks	Identical
Dark Oak Pressure Plate	dark_oak_pressure_plate	Dark Oak Pressure Plate	Identical
Dark Oak Sapling	dark_oak_sapling	Dark Oak Sapling	Identical
Dark Oak Sign	dark_oak_sign	Dark Oak Sign	Identical
Dark Oak Slab	dark_oak_slab	Dark Oak Slab	Identical
Dark Oak Stairs	dark_oak_stairs	Dark Oak Stairs	Identical
Dark Oak Trapdoor	dark_oak_trapdoor	Dark Oak Trapdoor	Identical
Dark Oak Wall Sign	dark_oak_wall_sign	Dark Oak Wall Sign	dark_oak_sign
Dark Oak Wood	dark_oak_wood	Dark Oak Wood	Identical
Dark Prismarine	dark_prismarine	Dark Prismarine	Identical
Dark Prismarine Slab	dark_prismarine_slab	Dark Prismarine Slab	Identical
Dark Prismarine Stairs	dark_prismarine_stairs	Dark Prismarine Stairs	Identical
Daylight Detector	daylight_detector	Daylight Detector	Identical
Dead Brain Coral	dead_brain_coral	Dead Brain Coral	Identical
Dead Brain Coral Block	dead_brain_coral_block	Dead Brain Coral Block	Identical
Dead Brain Coral Fan	dead_brain_coral_fan	Dead Brain Coral Fan	Identical
Dead Brain Coral Wall Fan	dead_brain_coral_wall_fan	Dead Brain Coral Wall Fan	dead_brain_coral_fan
Dead Bubble Coral	dead_bubble_coral	Dead Bubble Coral	Identical
Dead Bubble Coral Block	dead_bubble_coral_block	Dead Bubble Coral Block	Identical
Dead Bubble Coral Fan	dead_bubble_coral_fan	Dead Bubble Coral Fan	Identical
Dead Bubble Coral Wall Fan	dead_bubble_coral_wall_fan	Dead Bubble Coral Wall Fan	dead_bubble_coral_fan
Dead Bush	dead_bush	Dead Bush	Identical
Dead Fire Coral	dead_fire_coral	Dead Fire Coral	Identical
Dead Fire Coral Block	dead_fire_coral_block	Dead Fire Coral Block	Identical
Dead Fire Coral Fan	dead_fire_coral_fan	Dead Fire Coral Fan	Identical
Dead Fire Coral Wall Fan	dead_fire_coral_wall_fan	Dead Fire Coral Wall Fan	dead_fire_coral_fan
Dead Horn Coral	dead_horn_coral	Dead Horn Coral	Identical
Dead Horn Coral Block	dead_horn_coral_block	Dead Horn Coral Block	Identical
Dead Horn Coral Fan	dead_horn_coral_fan	Dead Horn Coral Fan	Identical
Dead Horn Coral Wall Fan	dead_horn_coral_wall_fan	Dead Horn Coral Wall Fan	dead_horn_coral_fan
Dead Tube Coral	dead_tube_coral	Dead Tube Coral	Identical
Dead Tube Coral Block	dead_tube_coral_block	Dead Tube Coral Block	Identical
Dead Tube Coral Fan	dead_tube_coral_fan	Dead Tube Coral Fan	Identical
Dead Tube Coral Wall Fan	dead_tube_coral_wall_fan	Dead Tube Coral Wall Fan	dead_tube_coral_fan
Deepslate	deepslate	Deepslate	Identical
Deepslate Brick Slab	deepslate_brick_slab	Deepslate Brick Slab	Identical
Deepslate Brick Stairs	deepslate_brick_stairs	Deepslate Brick Stairs	Identical
Deepslate Brick Wall	deepslate_brick_wall	Deepslate Brick Wall	Identical
Deepslate Bricks	deepslate_bricks	Deepslate Bricks	Identical
Deepslate Coal Ore	deepslate_coal_ore	Deepslate Coal Ore	Identical
Deepslate Copper Ore	deepslate_copper_ore	Deepslate Copper Ore	Identical
Deepslate Diamond Ore	deepslate_diamond_ore	Deepslate Diamond Ore	Identical
Deepslate Emerald Ore	deepslate_emerald_ore	Deepslate Emerald Ore	Identical
Deepslate Gold Ore	deepslate_gold_ore	Deepslate Gold Ore	Identical
Deepslate Iron Ore	deepslate_iron_ore	Deepslate Iron Ore	Identical
Deepslate Lapis Lazuli Ore	deepslate_lapis_ore	Deepslate Lapis Lazuli Ore	Identical
Deepslate Redstone Ore	deepslate_redstone_ore	Deepslate Redstone Ore	Identical
Deepslate Tile Slab	deepslate_tile_slab	Deepslate Tile Slab	Identical
Deepslate Tile Stairs	deepslate_tile_stairs	Deepslate Tile Stairs	Identical
Deepslate Tile Wall	deepslate_tile_wall	Deepslate Tile Wall	Identical
Deepslate Tiles	deepslate_tiles	Deepslate Tiles	Identical
Detector Rail	detector_rail	Detector Rail	Identical
Block of Diamond	diamond_block	Block of Diamond	Identical
Diamond Ore	diamond_ore	Diamond Ore	Identical
Diorite	diorite	Diorite	Identical
Diorite Slab	diorite_slab	Diorite Slab	Identical
Diorite Stairs	diorite_stairs	Diorite Stairs	Identical
Diorite Wall	diorite_wall	Diorite Wall	Identical
Dirt	dirt	Dirt	Identical
Dirt Path	dirt_path	Dirt Path	Identical
Dispenser	dispenser	Dispenser	Identical
Dragon Egg	dragon_egg	Dragon Egg	Identical
Dragon Head	dragon_head	Dragon Head	Identical
Dragon Wall Head	dragon_wall_head	Dragon Wall Head	dragon_head
Dried Kelp Block	dried_kelp_block	Dried Kelp Block	Identical
Dripstone Block	dripstone_block	Dripstone Block	Identical
Dropper	dropper	Dropper	Identical
Block of Emerald	emerald_block	Block of Emerald	Identical
Emerald Ore	emerald_ore	Emerald Ore	Identical
Enchanting Table	enchanting_table	Enchanting Table	Identical
End Gateway	end_gateway	End Gateway	None
End Portal	end_portal	End Portal	None
End Portal Frame	end_portal_frame	End Portal Frame	Identical
End Rod	end_rod	End Rod	Identical
End Stone	end_stone	End Stone	Identical
End Stone Brick Slab	end_stone_brick_slab	End Stone Brick Slab	Identical
End Stone Brick Stairs	end_stone_brick_stairs	End Stone Brick Stairs	Identical
End Stone Brick Wall	end_stone_brick_wall	End Stone Brick Wall	Identical
End Stone Bricks	end_stone_bricks	End Stone Bricks	Identical
Ender Chest	ender_chest	Ender Chest	Identical
Exposed Copper	exposed_copper	Exposed Copper	Identical
Exposed Cut Copper	exposed_cut_copper	Exposed Cut Copper	Identical
Exposed Cut Copper Slab	exposed_cut_copper_slab	Exposed Cut Copper Slab	Identical
Exposed Cut Copper Stairs	exposed_cut_copper_stairs	Exposed Cut Copper Stairs	Identical
Farmland	farmland	Farmland	Identical
Fern	fern	Fern	Identical
Fire	fire	Fire	None
Fire Coral	fire_coral	Fire Coral	Identical
Fire Coral Block	fire_coral_block	Fire Coral Block	Identical
Fire Coral Fan	fire_coral_fan	Fire Coral Fan	Identical
Fire Coral Wall Fan	fire_coral_wall_fan	Fire Coral Wall Fan	fire_coral_fan
Fletching Table	fletching_table	Fletching Table	Identical
Flower Pot	flower_pot	Flower Pot	Identical
Flowering Azalea	flowering_azalea	Flowering Azalea	Identical
Flowering Azalea Leaves	flowering_azalea_leaves	Flowering Azalea Leaves	Identical
Frosted Ice	frosted_ice	Frosted Ice	None
Furnace	furnace	Furnace	Identical
Gilded Blackstone	gilded_blackstone	Gilded Blackstone	Identical
Glass	glass	Glass	Identical
Glass Pane	glass_pane	Glass Pane	Identical
Glow Lichen	glow_lichen	Glow Lichen	Identical
Glowstone	glowstone	Glowstone	Identical
Block of Gold	gold_block	Block of Gold	Identical
Gold Ore	gold_ore	Gold Ore	Identical
Granite	granite	Granite	Identical
Granite Slab	granite_slab	Granite Slab	Identical
Granite Stairs	granite_stairs	Granite Stairs	Identical
Granite Wall	granite_wall	Granite Wall	Identical
Grass	grass	Grass	Identical
Grass Block	grass_block	Grass Block	Identical
Gravel	gravel	Gravel	Identical
Gray Banner	gray_banner	Gray Banner	Identical
Gray Bed	gray_bed	Gray Bed	Identical
Gray Candle	gray_candle	Gray Candle	Identical
Cake with Gray Candle	gray_candle_cake	Cake with Gray Candle	cake
Gray Carpet	gray_carpet	Gray Carpet	Identical
Gray Concrete	gray_concrete	Gray Concrete	Identical
Gray Concrete Powder	gray_concrete_powder	Gray Concrete Powder	Identical
Gray Glazed Terracotta	gray_glazed_terracotta	Gray Glazed Terracotta	Identical
Gray Shulker Box	gray_shulker_box	Gray Shulker Box	Identical
Gray Stained Glass	gray_stained_glass	Gray Stained Glass	Identical
Gray Stained Glass Pane	gray_stained_glass_pane	Gray Stained Glass Pane	Identical
Gray Terracotta	gray_terracotta	Gray Terracotta	Identical
Gray Wall Banner	gray_wall_banner	Gray Wall Banner	gray_banner
Gray Wool	gray_wool	Gray Wool	Identical
Green Banner	green_banner	Green Banner	Identical
Green Bed	green_bed	Green Bed	Identical
Green Candle	green_candle	Green Candle	Identical
Cake with Green Candle	green_candle_cake	Cake with Green Candle	cake
Green Carpet	green_carpet	Green Carpet	Identical
Green Concrete	green_concrete	Green Concrete	Identical
Green Concrete Powder	green_concrete_powder	Green Concrete Powder	Identical
Green Glazed Terracotta	green_glazed_terracotta	Green Glazed Terracotta	Identical
Green Shulker Box	green_shulker_box	Green Shulker Box	Identical
Green Stained Glass	green_stained_glass	Green Stained Glass	Identical
Green Stained Glass Pane	green_stained_glass_pane	Green Stained Glass Pane	Identical
Green Terracotta	green_terracotta	Green Terracotta	Identical
Green Wall Banner	green_wall_banner	Green Wall Banner	green_banner
Green Wool	green_wool	Green Wool	Identical
Grindstone	grindstone	Grindstone	Identical
Hanging Roots	hanging_roots	Hanging Roots	Identical
Hay Bale	hay_block	Hay Bale	Identical
Heavy Weighted Pressure Plate	heavy_weighted_pressure_plate	Heavy Weighted Pressure Plate	Identical
Honey Block	honey_block	Honey Block	Identical
Honeycomb Block	honeycomb_block	Honeycomb Block	Identical
Hopper	hopper	Hopper	Identical
Horn Coral	horn_coral	Horn Coral	Identical
Horn Coral Block	horn_coral_block	Horn Coral Block	Identical
Horn Coral Fan	horn_coral_fan	Horn Coral Fan	Identical
Horn Coral Wall Fan	horn_coral_wall_fan	Horn Coral Wall Fan	horn_coral_fan
Ice	ice	Ice	Identical
Infested Chiseled Stone Bricks	infested_chiseled_stone_bricks	Infested Chiseled Stone Bricks	Identical
Infested Cobblestone	infested_cobblestone	Infested Cobblestone	Identical
Infested Cracked Stone Bricks	infested_cracked_stone_bricks	Infested Cracked Stone Bricks	Identical
Infested Deepslate	infested_deepslate	Infested Deepslate	Identical
Infested Mossy Stone Bricks	infested_mossy_stone_bricks	Infested Mossy Stone Bricks	Identical
Infested Stone	infested_stone	Infested Stone	Identical
Infested Stone Bricks	infested_stone_bricks	Infested Stone Bricks	Identical
Iron Bars	iron_bars	Iron Bars	Identical
Block of Iron	iron_block	Block of Iron	Identical
Iron Door	iron_door	Iron Door	Identical
Iron Ore	iron_ore	Iron Ore	Identical
Iron Trapdoor	iron_trapdoor	Iron Trapdoor	Identical
Jack o'Lantern	jack_o_lantern	Jack o'Lantern	Identical
Jigsaw Block	jigsaw	Jigsaw Block	Identical
Jukebox	jukebox	Jukebox	Identical
Jungle Button	jungle_button	Jungle Button	Identical
Jungle Door	jungle_door	Jungle Door	Identical
Jungle Fence	jungle_fence	Jungle Fence	Identical
Jungle Fence Gate	jungle_fence_gate	Jungle Fence Gate	Identical
Jungle Leaves	jungle_leaves	Jungle Leaves	Identical
Jungle Log	jungle_log	Jungle Log	Identical
Jungle Planks	jungle_planks	Jungle Planks	Identical
Jungle Pressure Plate	jungle_pressure_plate	Jungle Pressure Plate	Identical
Jungle Sapling	jungle_sapling	Jungle Sapling	Identical
Jungle Sign	jungle_sign	Jungle Sign	Identical
Jungle Slab	jungle_slab	Jungle Slab	Identical
Jungle Stairs	jungle_stairs	Jungle Stairs	Identical
Jungle Trapdoor	jungle_trapdoor	Jungle Trapdoor	Identical
Jungle Wall Sign	jungle_wall_sign	Jungle Wall Sign	jungle_sign
Jungle Wood	jungle_wood	Jungle Wood	Identical
Kelp	kelp	Kelp	Identical
Kelp Plant	kelp_plant	Kelp Plant	kelp
Ladder	ladder	Ladder	Identical
Lantern	lantern	Lantern	Identical
Block of Lapis Lazuli	lapis_block	Block of Lapis Lazuli	Identical
Lapis Lazuli Ore	lapis_ore	Lapis Lazuli Ore	Identical
Large Amethyst Bud	large_amethyst_bud	Large Amethyst Bud	Identical
Large Fern	large_fern	Large Fern	Identical
Lava	lava	Lava	None
Lava Cauldron	lava_cauldron	Lava Cauldron	cauldron
Lectern	lectern	Lectern	Identical
Lever	lever	Lever	Identical
Light	light	Light	Identical
Light Blue Banner	light_blue_banner	Light Blue Banner	Identical
Light Blue Bed	light_blue_bed	Light Blue Bed	Identical
Light Blue Candle	light_blue_candle	Light Blue Candle	Identical
Cake with Light Blue Candle	light_blue_candle_cake	Cake with Light Blue Candle	cake
Light Blue Carpet	light_blue_carpet	Light Blue Carpet	Identical
Light Blue Concrete	light_blue_concrete	Light Blue Concrete	Identical
Light Blue Concrete Powder	light_blue_concrete_powder	Light Blue Concrete Powder	Identical
Light Blue Glazed Terracotta	light_blue_glazed_terracotta	Light Blue Glazed Terracotta	Identical
Light Blue Shulker Box	light_blue_shulker_box	Light Blue Shulker Box	Identical
Light Blue Stained Glass	light_blue_stained_glass	Light Blue Stained Glass	Identical
Light Blue Stained Glass Pane	light_blue_stained_glass_pane	Light Blue Stained Glass Pane	Identical
Light Blue Terracotta	light_blue_terracotta	Light Blue Terracotta	Identical
Light Blue Wall Banner	light_blue_wall_banner	Light Blue Wall Banner	light_blue_banner
Light Blue Wool	light_blue_wool	Light Blue Wool	Identical
Light Gray Banner	light_gray_banner	Light Gray Banner	Identical
Light Gray Bed	light_gray_bed	Light Gray Bed	Identical
Light Gray Candle	light_gray_candle	Light Gray Candle	Identical
Cake with Light Gray Candle	light_gray_candle_cake	Cake with Light Gray Candle	cake
Light Gray Carpet	light_gray_carpet	Light Gray Carpet	Identical
Light Gray Concrete	light_gray_concrete	Light Gray Concrete	Identical
Light Gray Concrete Powder	light_gray_concrete_powder	Light Gray Concrete Powder	Identical
Light Gray Glazed Terracotta	light_gray_glazed_terracotta	Light Gray Glazed Terracotta	Identical
Light Gray Shulker Box	light_gray_shulker_box	Light Gray Shulker Box	Identical
Light Gray Stained Glass	light_gray_stained_glass	Light Gray Stained Glass	Identical
Light Gray Stained Glass Pane	light_gray_stained_glass_pane	Light Gray Stained Glass Pane	Identical
Light Gray Terracotta	light_gray_terracotta	Light Gray Terracotta	Identical
Light Gray Wall Banner	light_gray_wall_banner	Light Gray Wall Banner	light_gray_banner
Light Gray Wool	light_gray_wool	Light Gray Wool	Identical
Light Weighted Pressure Plate	light_weighted_pressure_plate	Light Weighted Pressure Plate	Identical
Lightning Rod	lightning_rod	Lightning Rod	Identical
Lilac	lilac	Lilac	Identical
Lily of the Valley	lily_of_the_valley	Lily of the Valley	Identical
Lily Pad	lily_pad	Lily Pad	Identical
Lime Banner	lime_banner	Lime Banner	Identical
Lime Bed	lime_bed	Lime Bed	Identical
Lime Candle	lime_candle	Lime Candle	Identical
Cake with Lime Candle	lime_candle_cake	Cake with Lime Candle	cake
Lime Carpet	lime_carpet	Lime Carpet	Identical
Lime Concrete	lime_concrete	Lime Concrete	Identical
Lime Concrete Powder	lime_concrete_powder	Lime Concrete Powder	Identical
Lime Glazed Terracotta	lime_glazed_terracotta	Lime Glazed Terracotta	Identical
Lime Shulker Box	lime_shulker_box	Lime Shulker Box	Identical
Lime Stained Glass	lime_stained_glass	Lime Stained Glass	Identical
Lime Stained Glass Pane	lime_stained_glass_pane	Lime Stained Glass Pane	Identical
Lime Terracotta	lime_terracotta	Lime Terracotta	Identical
Lime Wall Banner	lime_wall_banner	Lime Wall Banner	lime_banner
Lime Wool	lime_wool	Lime Wool	Identical
Lodestone	lodestone	Lodestone	Identical
Loom	loom	Loom	Identical
Magenta Banner	magenta_banner	Magenta Banner	Identical
Magenta Bed	magenta_bed	Magenta Bed	Identical
Magenta Candle	magenta_candle	Magenta Candle	Identical
Cake with Magenta Candle	magenta_candle_cake	Cake with Magenta Candle	cake
Magenta Carpet	magenta_carpet	Magenta Carpet	Identical
Magenta Concrete	magenta_concrete	Magenta Concrete	Identical
Magenta Concrete Powder	magenta_concrete_powder	Magenta Concrete Powder	Identical
Magenta Glazed Terracotta	magenta_glazed_terracotta	Magenta Glazed Terracotta	Identical
Magenta Shulker Box	magenta_shulker_box	Magenta Shulker Box	Identical
Magenta Stained Glass	magenta_stained_glass	Magenta Stained Glass	Identical
Magenta Stained Glass Pane	magenta_stained_glass_pane	Magenta Stained Glass Pane	Identical
Magenta Terracotta	magenta_terracotta	Magenta Terracotta	Identical
Magenta Wall Banner	magenta_wall_banner	Magenta Wall Banner	magenta_banner
Magenta Wool	magenta_wool	Magenta Wool	Identical
Magma Block	magma_block	Magma Block	Identical
Medium Amethyst Bud	medium_amethyst_bud	Medium Amethyst Bud	Identical
Melon	melon	Melon	Identical
Melon Stem	melon_stem	Melon Stem	melon_seeds
Moss Block	moss_block	Moss Block	Identical
Moss Carpet	moss_carpet	Moss Carpet	Identical
Mossy Cobblestone	mossy_cobblestone	Mossy Cobblestone	Identical
Mossy Cobblestone Slab	mossy_cobblestone_slab	Mossy Cobblestone Slab	Identical
Mossy Cobblestone Stairs	mossy_cobblestone_stairs	Mossy Cobblestone Stairs	Identical
Mossy Cobblestone Wall	mossy_cobblestone_wall	Mossy Cobblestone Wall	Identical
Mossy Stone Brick Slab	mossy_stone_brick_slab	Mossy Stone Brick Slab	Identical
Mossy Stone Brick Stairs	mossy_stone_brick_stairs	Mossy Stone Brick Stairs	Identical
Mossy Stone Brick Wall	mossy_stone_brick_wall	Mossy Stone Brick Wall	Identical
Mossy Stone Bricks	mossy_stone_bricks	Mossy Stone Bricks	Identical
Moving Piston	moving_piston	Moving Piston	None
Mushroom Stem	mushroom_stem	Mushroom Stem	Identical
Mycelium	mycelium	Mycelium	Identical
Nether Brick Fence	nether_brick_fence	Nether Brick Fence	Identical
Nether Brick Slab	nether_brick_slab	Nether Brick Slab	Identical
Nether Brick Stairs	nether_brick_stairs	Nether Brick Stairs	Identical
Nether Brick Wall	nether_brick_wall	Nether Brick Wall	Identical
Nether Bricks	nether_bricks	Nether Bricks	Identical
Nether Gold Ore	nether_gold_ore	Nether Gold Ore	Identical
Nether Portal	nether_portal	Nether Portal	None
Nether Quartz Ore	nether_quartz_ore	Nether Quartz Ore	Identical
Nether Sprouts	nether_sprouts	Nether Sprouts	Identical
Nether Wart	nether_wart	Nether Wart	Identical
Nether Wart Block	nether_wart_block	Nether Wart Block	Identical
Block of Netherite	netherite_block	Block of Netherite	Identical
Netherrack	netherrack	Netherrack	Identical
Note Block	note_block	Note Block	Identical
Oak Button	oak_button	Oak Button	Identical
Oak Door	oak_door	Oak Door	Identical
Oak Fence	oak_fence	Oak Fence	Identical
Oak Fence Gate	oak_fence_gate	Oak Fence Gate	Identical
Oak Leaves	oak_leaves	Oak Leaves	Identical
Oak Log	oak_log	Oak Log	Identical
Oak Planks	oak_planks	Oak Planks	Identical
Oak Pressure Plate	oak_pressure_plate	Oak Pressure Plate	Identical
Oak Sapling	oak_sapling	Oak Sapling	Identical
Oak Sign	oak_sign	Oak Sign	Identical
Oak Slab	oak_slab	Oak Slab	Identical
Oak Stairs	oak_stairs	Oak Stairs	Identical
Oak Trapdoor	oak_trapdoor	Oak Trapdoor	Identical
Oak Wall Sign	oak_wall_sign	Oak Wall Sign	oak_sign
Oak Wood	oak_wood	Oak Wood	Identical
Observer	observer	Observer	Identical
Obsidian	obsidian	Obsidian	Identical
Orange Banner	orange_banner	Orange Banner	Identical
Orange Bed	orange_bed	Orange Bed	Identical
Orange Candle	orange_candle	Orange Candle	Identical
Cake with Orange Candle	orange_candle_cake	Cake with Orange Candle	cake
Orange Carpet	orange_carpet	Orange Carpet	Identical
Orange Concrete	orange_concrete	Orange Concrete	Identical
Orange Concrete Powder	orange_concrete_powder	Orange Concrete Powder	Identical
Orange Glazed Terracotta	orange_glazed_terracotta	Orange Glazed Terracotta	Identical
Orange Shulker Box	orange_shulker_box	Orange Shulker Box	Identical
Orange Stained Glass	orange_stained_glass	Orange Stained Glass	Identical
Orange Stained Glass Pane	orange_stained_glass_pane	Orange Stained Glass Pane	Identical
Orange Terracotta	orange_terracotta	Orange Terracotta	Identical
Orange Tulip	orange_tulip	Orange Tulip	Identical
Orange Wall Banner	orange_wall_banner	Orange Wall Banner	orange_banner
Orange Wool	orange_wool	Orange Wool	Identical
Oxeye Daisy	oxeye_daisy	Oxeye Daisy	Identical
Oxidized Copper	oxidized_copper	Oxidized Copper	Identical
Oxidized Cut Copper	oxidized_cut_copper	Oxidized Cut Copper	Identical
Oxidized Cut Copper Slab	oxidized_cut_copper_slab	Oxidized Cut Copper Slab	Identical
Oxidized Cut Copper Stairs	oxidized_cut_copper_stairs	Oxidized Cut Copper Stairs	Identical
Packed Ice	packed_ice	Packed Ice	Identical
Peony	peony	Peony	Identical
Petrified Oak Slab	petrified_oak_slab	Petrified Oak Slab	Identical
Pink Banner	pink_banner	Pink Banner	Identical
Pink Bed	pink_bed	Pink Bed	Identical
Pink Candle	pink_candle	Pink Candle	Identical
Cake with Pink Candle	pink_candle_cake	Cake with Pink Candle	cake
Pink Carpet	pink_carpet	Pink Carpet	Identical
Pink Concrete	pink_concrete	Pink Concrete	Identical
Pink Concrete Powder	pink_concrete_powder	Pink Concrete Powder	Identical
Pink Glazed Terracotta	pink_glazed_terracotta	Pink Glazed Terracotta	Identical
Pink Shulker Box	pink_shulker_box	Pink Shulker Box	Identical
Pink Stained Glass	pink_stained_glass	Pink Stained Glass	Identical
Pink Stained Glass Pane	pink_stained_glass_pane	Pink Stained Glass Pane	Identical
Pink Terracotta	pink_terracotta	Pink Terracotta	Identical
Pink Tulip	pink_tulip	Pink Tulip	Identical
Pink Wall Banner	pink_wall_banner	Pink Wall Banner	pink_banner
Pink Wool	pink_wool	Pink Wool	Identical
Piston	piston	Piston	Identical
Piston Head	piston_head	Piston Head	None
Player Head	player_head	Player Head	Identical
Player Wall Head	player_wall_head	Player Wall Head	player_head
Podzol	podzol	Podzol	Identical
Pointed Dripstone	pointed_dripstone	Pointed Dripstone	Identical
Polished Andesite	polished_andesite	Polished Andesite	Identical
Polished Andesite Slab	polished_andesite_slab	Polished Andesite Slab	Identical
Polished Andesite Stairs	polished_andesite_stairs	Polished Andesite Stairs	Identical
Polished Basalt	polished_basalt	Polished Basalt	Identical
Polished Blackstone	polished_blackstone	Polished Blackstone	Identical
Polished Blackstone Brick Slab	polished_blackstone_brick_slab	Polished Blackstone Brick Slab	Identical
Polished Blackstone Brick Stairs	polished_blackstone_brick_stairs	Polished Blackstone Brick Stairs	Identical
Polished Blackstone Brick Wall	polished_blackstone_brick_wall	Polished Blackstone Brick Wall	Identical
Polished Blackstone Bricks	polished_blackstone_bricks	Polished Blackstone Bricks	Identical
Polished Blackstone Button	polished_blackstone_button	Polished Blackstone Button	Identical
Polished Blackstone Pressure Plate	polished_blackstone_pressure_plate	Polished Blackstone Pressure Plate	Identical
Polished Blackstone Slab	polished_blackstone_slab	Polished Blackstone Slab	Identical
Polished Blackstone Stairs	polished_blackstone_stairs	Polished Blackstone Stairs	Identical
Polished Blackstone Wall	polished_blackstone_wall	Polished Blackstone Wall	Identical
Polished Deepslate	polished_deepslate	Polished Deepslate	Identical
Polished Deepslate Slab	polished_deepslate_slab	Polished Deepslate Slab	Identical
Polished Deepslate Stairs	polished_deepslate_stairs	Polished Deepslate Stairs	Identical
Polished Deepslate Wall	polished_deepslate_wall	Polished Deepslate Wall	Identical
Polished Diorite	polished_diorite	Polished Diorite	Identical
Polished Diorite Slab	polished_diorite_slab	Polished Diorite Slab	Identical
Polished Diorite Stairs	polished_diorite_stairs	Polished Diorite Stairs	Identical
Polished Granite	polished_granite	Polished Granite	Identical
Polished Granite Slab	polished_granite_slab	Polished Granite Slab	Identical
Polished Granite Stairs	polished_granite_stairs	Polished Granite Stairs	Identical
Poppy	poppy	Poppy	Identical
Potatoes	potatoes	Potatoes	potato
Potted Acacia Sapling	potted_acacia_sapling	Potted Acacia Sapling	acacia_sapling
Potted Allium	potted_allium	Potted Allium	allium
Potted Azalea	potted_azalea_bush	Potted Azalea	azalea_bush
Potted Azure Bluet	potted_azure_bluet	Potted Azure Bluet	azure_bluet
Potted Bamboo	potted_bamboo	Potted Bamboo	bamboo
Potted Birch Sapling	potted_birch_sapling	Potted Birch Sapling	birch_sapling
Potted Blue Orchid	potted_blue_orchid	Potted Blue Orchid	blue_orchid
Potted Brown Mushroom	potted_brown_mushroom	Potted Brown Mushroom	brown_mushroom
Potted Cactus	potted_cactus	Potted Cactus	cactus
Potted Cornflower	potted_cornflower	Potted Cornflower	cornflower
Potted Crimson Fungus	potted_crimson_fungus	Potted Crimson Fungus	crimson_fungus
Potted Crimson Roots	potted_crimson_roots	Potted Crimson Roots	crimson_roots
Potted Dandelion	potted_dandelion	Potted Dandelion	dandelion
Potted Dark Oak Sapling	potted_dark_oak_sapling	Potted Dark Oak Sapling	dark_oak_sapling
Potted Dead Bush	potted_dead_bush	Potted Dead Bush	dead_bush
Potted Fern	potted_fern	Potted Fern	fern
Potted Flowering Azalea	potted_flowering_azalea_bush	Potted Flowering Azalea	flowering_azalea
Potted Jungle Sapling	potted_jungle_sapling	Potted Jungle Sapling	jungle_sapling
Potted Lily of the Valley	potted_lily_of_the_valley	Potted Lily of the Valley	lily_of_the_valley
Potted Oak Sapling	potted_oak_sapling	Potted Oak Sapling	oak_sapling
Potted Orange Tulip	potted_orange_tulip	Potted Orange Tulip	orange_tulip
Potted Oxeye Daisy	potted_oxeye_daisy	Potted Oxeye Daisy	oxeye_daisy
Potted Pink Tulip	potted_pink_tulip	Potted Pink Tulip	pink_tulip
Potted Poppy	potted_poppy	Potted Poppy	poppy
Potted Red Mushroom	potted_red_mushroom	Potted Red Mushroom	red_mushroom
Potted Red Tulip	potted_red_tulip	Potted Red Tulip	red_tulip
Potted Spruce Sapling	potted_spruce_sapling	Potted Spruce Sapling	spruce_sapling
Potted Warped Fungus	potted_warped_fungus	Potted Warped Fungus	warped_fungus
Potted Warped Roots	potted_warped_roots	Potted Warped Roots	warped_roots
Potted White Tulip	potted_white_tulip	Potted White Tulip	white_tulip
Potted Wither Rose	potted_wither_rose	Potted Wither Rose	wither_rose
Powder Snow	powder_snow	Powder Snow	powder_snow_bucket
Powder Snow Cauldron	powder_snow_cauldron	Powder Snow Cauldron	cauldron
Powered Rail	powered_rail	Powered Rail	Identical
Prismarine	prismarine	Prismarine	Identical
Prismarine Brick Slab	prismarine_brick_slab	Prismarine Brick Slab	Identical
Prismarine Brick Stairs	prismarine_brick_stairs	Prismarine Brick Stairs	Identical
Prismarine Bricks	prismarine_bricks	Prismarine Bricks	Identical
Prismarine Slab	prismarine_slab	Prismarine Slab	Identical
Prismarine Stairs	prismarine_stairs	Prismarine Stairs	Identical
Prismarine Wall	prismarine_wall	Prismarine Wall	Identical
Pumpkin	pumpkin	Pumpkin	Identical
Pumpkin Stem	pumpkin_stem	Pumpkin Stem	pumpkin_seeds
Purple Banner	purple_banner	Purple Banner	Identical
Purple Bed	purple_bed	Purple Bed	Identical
Purple Candle	purple_candle	Purple Candle	Identical
Cake with Purple Candle	purple_candle_cake	Cake with Purple Candle	cake
Purple Carpet	purple_carpet	Purple Carpet	Identical
Purple Concrete	purple_concrete	Purple Concrete	Identical
Purple Concrete Powder	purple_concrete_powder	Purple Concrete Powder	Identical
Purple Glazed Terracotta	purple_glazed_terracotta	Purple Glazed Terracotta	Identical
Purple Shulker Box	purple_shulker_box	Purple Shulker Box	Identical
Purple Stained Glass	purple_stained_glass	Purple Stained Glass	Identical
Purple Stained Glass Pane	purple_stained_glass_pane	Purple Stained Glass Pane	Identical
Purple Terracotta	purple_terracotta	Purple Terracotta	Identical
Purple Wall Banner	purple_wall_banner	Purple Wall Banner	purple_banner
Purple Wool	purple_wool	Purple Wool	Identical
Purpur Block	purpur_block	Purpur Block	Identical
Purpur Pillar	purpur_pillar	Purpur Pillar	Identical
Purpur Slab	purpur_slab	Purpur Slab	Identical
Purpur Stairs	purpur_stairs	Purpur Stairs	Identical
Block of Quartz	quartz_block	Block of Quartz	Identical
Quartz Bricks	quartz_bricks	Quartz Bricks	Identical
Quartz Pillar	quartz_pillar	Quartz Pillar	Identical
Quartz Slab	quartz_slab	Quartz Slab	Identical
Quartz Stairs	quartz_stairs	Quartz Stairs	Identical
Rail	rail	Rail	Identical
Block of Raw Copper	raw_copper_block	Block of Raw Copper	Identical
Block of Raw Gold	raw_gold_block	Block of Raw Gold	Identical
Block of Raw Iron	raw_iron_block	Block of Raw Iron	Identical
Red Banner	red_banner	Red Banner	Identical
Red Bed	red_bed	Red Bed	Identical
Red Candle	red_candle	Red Candle	Identical
Cake with Red Candle	red_candle_cake	Cake with Red Candle	cake
Red Carpet	red_carpet	Red Carpet	Identical
Red Concrete	red_concrete	Red Concrete	Identical
Red Concrete Powder	red_concrete_powder	Red Concrete Powder	Identical
Red Glazed Terracotta	red_glazed_terracotta	Red Glazed Terracotta	Identical
Red Mushroom	red_mushroom	Red Mushroom	Identical
Red Mushroom Block	red_mushroom_block	Red Mushroom Block	Identical
Red Nether Brick Slab	red_nether_brick_slab	Red Nether Brick Slab	Identical
Red Nether Brick Stairs	red_nether_brick_stairs	Red Nether Brick Stairs	Identical
Red Nether Brick Wall	red_nether_brick_wall	Red Nether Brick Wall	Identical
Red Nether Bricks	red_nether_bricks	Red Nether Bricks	Identical
Red Sand	red_sand	Red Sand	Identical
Red Sandstone	red_sandstone	Red Sandstone	Identical
Red Sandstone Slab	red_sandstone_slab	Red Sandstone Slab	Identical
Red Sandstone Stairs	red_sandstone_stairs	Red Sandstone Stairs	Identical
Red Sandstone Wall	red_sandstone_wall	Red Sandstone Wall	Identical
Red Shulker Box	red_shulker_box	Red Shulker Box	Identical
Red Stained Glass	red_stained_glass	Red Stained Glass	Identical
Red Stained Glass Pane	red_stained_glass_pane	Red Stained Glass Pane	Identical
Red Terracotta	red_terracotta	Red Terracotta	Identical
Red Tulip	red_tulip	Red Tulip	Identical
Red Wall Banner	red_wall_banner	Red Wall Banner	red_banner
Red Wool	red_wool	Red Wool	Identical
Block of Redstone	redstone_block	Block of Redstone	Identical
Redstone Lamp	redstone_lamp	Redstone Lamp	Identical
Redstone Ore	redstone_ore	Redstone Ore	Identical
Redstone Torch	redstone_torch	Redstone Torch	Identical
Redstone Wall Torch	redstone_wall_torch	Redstone Wall Torch	redstone_torch
Redstone Wire	redstone_wire	Redstone Wire	redstone
Redstone Repeater	repeater	Redstone Repeater	Identical
Repeating Command Block	repeating_command_block	Repeating Command Block	Identical
Respawn Anchor	respawn_anchor	Respawn Anchor	Identical
Rooted Dirt	rooted_dirt	Rooted Dirt	Identical
Rose Bush	rose_bush	Rose Bush	Identical
Sand	sand	Sand	Identical
Sandstone	sandstone	Sandstone	Identical
Sandstone Slab	sandstone_slab	Sandstone Slab	Identical
Sandstone Stairs	sandstone_stairs	Sandstone Stairs	Identical
Sandstone Wall	sandstone_wall	Sandstone Wall	Identical
Scaffolding	scaffolding	Scaffolding	Identical
Sculk Sensor	sculk_sensor	Sculk Sensor	Identical
Sea Lantern	sea_lantern	Sea Lantern	Identical
Sea Pickle	sea_pickle	Sea Pickle	Identical
Seagrass	seagrass	Seagrass	Identical
Shroomlight	shroomlight	Shroomlight	Identical
Shulker Box	shulker_box	Shulker Box	Identical
Skeleton Skull	skeleton_skull	Skeleton Skull	Identical
Skeleton Wall Skull (S)	skeleton_wall_skull	Skeleton Wall Skull	skeleton_skull
Slime Block	slime_block	Slime Block	Identical
Small Amethyst Bud	small_amethyst_bud	Small Amethyst Bud	Identical
Small Dripleaf	small_dripleaf	Small Dripleaf	Identical
Smithing Table	smithing_table	Smithing Table	Identical
Smoker	smoker	Smoker	Identical
Smooth Basalt	smooth_basalt	Smooth Basalt	Identical
Smooth Quartz Block	smooth_quartz	Smooth Quartz Block	Identical
Smooth Quartz Slab	smooth_quartz_slab	Smooth Quartz Slab	Identical
Smooth Quartz Stairs	smooth_quartz_stairs	Smooth Quartz Stairs	Identical
Smooth Red Sandstone	smooth_red_sandstone	Smooth Red Sandstone	Identical
Smooth Red Sandstone Slab	smooth_red_sandstone_slab	Smooth Red Sandstone Slab	Identical
Smooth Red Sandstone Stairs	smooth_red_sandstone_stairs	Smooth Red Sandstone Stairs	Identical
Smooth Sandstone	smooth_sandstone	Smooth Sandstone	Identical
Smooth Sandstone Slab	smooth_sandstone_slab	Smooth Sandstone Slab	Identical
Smooth Sandstone Stairs	smooth_sandstone_stairs	Smooth Sandstone Stairs	Identical
Smooth Stone	smooth_stone	Smooth Stone	Identical
Smooth Stone Slab	smooth_stone_slab	Smooth Stone Slab	Identical
Snow	snow	Snow	Identical
Snow Block	snow_block	Snow Block	Identical
Soul Campfire	soul_campfire	Soul Campfire	Identical
Soul Fire	soul_fire	Soul Fire	None
Soul Lantern	soul_lantern	Soul Lantern	Identical
Soul Sand	soul_sand	Soul Sand	Identical
Soul Soil	soul_soil	Soul Soil	Identical
Soul Torch	soul_torch	Soul Torch	Identical
Soul Wall Torch	soul_wall_torch	Soul Wall Torch	soul_torch
Spawner	spawner	Monster Spawner	Identical
Sponge	sponge	Sponge	Identical
Spore Blossom	spore_blossom	Spore Blossom	Identical
Spruce Button	spruce_button	Spruce Button	Identical
Spruce Door	spruce_door	Spruce Door	Identical
Spruce Fence	spruce_fence	Spruce Fence	Identical
Spruce Fence Gate	spruce_fence_gate	Spruce Fence Gate	Identical
Spruce Leaves	spruce_leaves	Spruce Leaves	Identical
Spruce Log	spruce_log	Spruce Log	Identical
Spruce Planks	spruce_planks	Spruce Planks	Identical
Spruce Pressure Plate	spruce_pressure_plate	Spruce Pressure Plate	Identical
Spruce Sapling	spruce_sapling	Spruce Sapling	Identical
Spruce Sign	spruce_sign	Spruce Sign	Identical
Spruce Slab	spruce_slab	Spruce Slab	Identical
Spruce Stairs	spruce_stairs	Spruce Stairs	Identical
Spruce Trapdoor	spruce_trapdoor	Spruce Trapdoor	Identical
Spruce Wall Sign	spruce_wall_sign	Spruce Wall Sign	spruce_sign
Spruce Wood	spruce_wood	Spruce Wood	Identical
Sticky Piston	sticky_piston	Sticky Piston	Identical
Stone	stone	Stone	Identical
Stone Brick Slab	stone_brick_slab	Stone Brick Slab	Identical
Stone Brick Stairs	stone_brick_stairs	Stone Brick Stairs	Identical
Stone Brick Wall	stone_brick_wall	Stone Brick Wall	Identical
Stone Bricks	stone_bricks	Stone Bricks	Identical
Stone Button	stone_button	Stone Button	Identical
Stone Pressure Plate	stone_pressure_plate	Stone Pressure Plate	Identical
Stone Slab	stone_slab	Stone Slab	Identical
Stone Stairs	stone_stairs	Stone Stairs	Identical
Stonecutter	stonecutter	Stonecutter	Identical
Stripped Acacia Log	stripped_acacia_log	Stripped Acacia Log	Identical
Stripped Acacia Wood	stripped_acacia_wood	Stripped Acacia Wood	Identical
Stripped Birch Log	stripped_birch_log	Stripped Birch Log	Identical
Stripped Birch Wood	stripped_birch_wood	Stripped Birch Wood	Identical
Stripped Crimson Hyphae	stripped_crimson_hyphae	Stripped Crimson Hyphae	Identical
Stripped Crimson Stem	stripped_crimson_stem	Stripped Crimson Stem	Identical
Stripped Dark Oak Log	stripped_dark_oak_log	Stripped Dark Oak Log	Identical
Stripped Dark Oak Wood	stripped_dark_oak_wood	Stripped Dark Oak Wood	Identical
Stripped Jungle Log	stripped_jungle_log	Stripped Jungle Log	Identical
Stripped Jungle Wood	stripped_jungle_wood	Stripped Jungle Wood	Identical
Stripped Oak Log	stripped_oak_log	Stripped Oak Log	Identical
Stripped Oak Wood	stripped_oak_wood	Stripped Oak Wood	Identical
Stripped Spruce Log	stripped_spruce_log	Stripped Spruce Log	Identical
Stripped Spruce Wood	stripped_spruce_wood	Stripped Spruce Wood	Identical
Stripped Warped Hyphae	stripped_warped_hyphae	Stripped Warped Hyphae	Identical
Stripped Warped Stem	stripped_warped_stem	Stripped Warped Stem	Identical
Structure Block	structure_block	Structure Block	Identical
Structure Void	structure_void	Structure Void	Identical
Sugar Cane	sugar_cane	Sugar Cane	Identical
Sunflower	sunflower	Sunflower	Identical
Sweet Berry Bush	sweet_berry_bush	Sweet Berry Bush	sweet_berries
Tall Grass	tall_grass	Tall Grass	Identical
Tall Seagrass	tall_seagrass	Tall Seagrass	seagrass
Target	target	Target	Identical
Terracotta	terracotta	Terracotta	Identical
Tinted Glass	tinted_glass	Tinted Glass	Identical
TNT	tnt	TNT	Identical
Torch	torch	Torch	Identical
Trapped Chest	trapped_chest	Trapped Chest	Identical
Tripwire	tripwire	Tripwire	string
Tripwire Hook	tripwire_hook	Tripwire Hook	Identical
Tube Coral	tube_coral	Tube Coral	Identical
Tube Coral Block	tube_coral_block	Tube Coral Block	Identical
Tube Coral Fan	tube_coral_fan	Tube Coral Fan	Identical
Tube Coral Wall Fan	tube_coral_wall_fan	Tube Coral Wall Fan	tube_coral_fan
Tuff	tuff	Tuff	Identical
Turtle Egg	turtle_egg	Turtle Egg	Identical
Twisting Vines	twisting_vines	Twisting Vines	Identical
Twisting Vines Plant	twisting_vines_plant	Twisting Vines Plant	twisting_vines
Vines	vine	Vines	Identical
Void Air	void_air	Void Air	None
Wall Torch	wall_torch	Wall Torch	torch
Warped Button	warped_button	Warped Button	Identical
Warped Door	warped_door	Warped Door	Identical
Warped Fence	warped_fence	Warped Fence	Identical
Warped Fence Gate	warped_fence_gate	Warped Fence Gate	Identical
Warped Fungus	warped_fungus	Warped Fungus	Identical
Warped Hyphae	warped_hyphae	Warped Hyphae	Identical
Warped Nylium	warped_nylium	Warped Nylium	Identical
Warped Planks	warped_planks	Warped Planks	Identical
Warped Pressure Plate	warped_pressure_plate	Warped Pressure Plate	Identical
Warped Roots	warped_roots	Warped Roots	Identical
Warped Sign	warped_sign	Warped Sign	Identical
Warped Slab	warped_slab	Warped Slab	Identical
Warped Stairs	warped_stairs	Warped Stairs	Identical
Warped Stem	warped_stem	Warped Stem	Identical
Warped Trapdoor	warped_trapdoor	Warped Trapdoor	Identical
Warped Wall Sign	warped_wall_sign	Warped Wall Sign	warped_sign
Warped Wart Block	warped_wart_block	Warped Wart Block	Identical
Water	water	Water	None
Water Cauldron	water_cauldron	Water Cauldron	cauldron
Waxed Block of Copper	waxed_copper_block	Waxed Block of Copper	Identical
Waxed Cut Copper	waxed_cut_copper	Waxed Cut Copper	Identical
Waxed Cut Copper Slab	waxed_cut_copper_slab	Waxed Cut Copper Slab	Identical
Waxed Cut Copper Stairs	waxed_cut_copper_stairs	Waxed Cut Copper Stairs	Identical
Waxed Exposed Copper	waxed_exposed_copper	Waxed Exposed Copper	Identical
Waxed Exposed Cut Copper	waxed_exposed_cut_copper	Waxed Exposed Cut Copper	Identical
Waxed Exposed Cut Copper Slab	waxed_exposed_cut_copper_slab	Waxed Exposed Cut Copper Slab	Identical
Waxed Exposed Cut Copper Stairs	waxed_exposed_cut_copper_stairs	Waxed Exposed Cut Copper Stairs	Identical
Waxed Oxidized Copper	waxed_oxidized_copper	Waxed Oxidized Copper	Identical
Waxed Oxidized Cut Copper	waxed_oxidized_cut_copper	Waxed Oxidized Cut Copper	Identical
Waxed Oxidized Cut Copper Slab	waxed_oxidized_cut_copper_slab	Waxed Oxidized Cut Copper Slab	Identical
Waxed Oxidized Cut Copper Stairs	waxed_oxidized_cut_copper_stairs	Waxed Oxidized Cut Copper Stairs	Identical
Waxed Weathered Copper	waxed_weathered_copper	Waxed Weathered Copper	Identical
Waxed Weathered Cut Copper	waxed_weathered_cut_copper	Waxed Weathered Cut Copper	Identical
Waxed Weathered Cut Copper Slab	waxed_weathered_cut_copper_slab	Waxed Weathered Cut Copper Slab	Identical
Waxed Weathered Cut Copper Stairs	waxed_weathered_cut_copper_stairs	Waxed Weathered Cut Copper Stairs	Identical
Weathered Copper	weathered_copper	Weathered Copper	Identical
Weathered Cut Copper	weathered_cut_copper	Weathered Cut Copper	Identical
Weathered Cut Copper Slab	weathered_cut_copper_slab	Weathered Cut Copper Slab	Identical
Weathered Cut Copper Stairs	weathered_cut_copper_stairs	Weathered Cut Copper Stairs	Identical
Weeping Vines	weeping_vines	Weeping Vines	Identical
Weeping Vines Plant	weeping_vines_plant	Weeping Vines Plant	weeping_vines
Wet Sponge	wet_sponge	Wet Sponge	Identical
Wheat Crops	wheat	Wheat Crops	wheat_seeds
White Banner	white_banner	White Banner	Identical
White Bed	white_bed	White Bed	Identical
White Candle	white_candle	White Candle	Identical
Cake with White Candle	white_candle_cake	Cake with White Candle	cake
White Carpet	white_carpet	White Carpet	Identical
White Concrete	white_concrete	White Concrete	Identical
White Concrete Powder	white_concrete_powder	White Concrete Powder	Identical
White Glazed Terracotta	white_glazed_terracotta	White Glazed Terracotta	Identical
White Shulker Box	white_shulker_box	White Shulker Box	Identical
White Stained Glass	white_stained_glass	White Stained Glass	Identical
White Stained Glass Pane	white_stained_glass_pane	White Stained Glass Pane	Identical
White Terracotta	white_terracotta	White Terracotta	Identical
White Tulip	white_tulip	White Tulip	Identical
White Wall Banner	white_wall_banner	White Wall Banner	white_banner
White Wool	white_wool	White Wool	Identical
Wither Rose	wither_rose	Wither Rose	Identical
Wither Skeleton Skull	wither_skeleton_skull	Wither Skeleton Skull	Identical
Wither Skeleton Wall Skull (S)	wither_skeleton_wall_skull	Wither Skeleton Wall Skull	wither_skeleton_skull
Yellow Banner	yellow_banner	Yellow Banner	Identical
Yellow Bed	yellow_bed	Yellow Bed	Identical
Yellow Candle	yellow_candle	Yellow Candle	Identical
Cake with Yellow Candle	yellow_candle_cake	Cake with Yellow Candle	cake
Yellow Carpet	yellow_carpet	Yellow Carpet	Identical
Yellow Concrete	yellow_concrete	Yellow Concrete	Identical
Yellow Concrete Powder	yellow_concrete_powder	Yellow Concrete Powder	Identical
Yellow Glazed Terracotta	yellow_glazed_terracotta	Yellow Glazed Terracotta	Identical
Yellow Shulker Box	yellow_shulker_box	Yellow Shulker Box	Identical
Yellow Stained Glass	yellow_stained_glass	Yellow Stained Glass	Identical
Yellow Stained Glass Pane	yellow_stained_glass_pane	Yellow Stained Glass Pane	Identical
Yellow Terracotta	yellow_terracotta	Yellow Terracotta	Identical
Yellow Wall Banner	yellow_wall_banner	Yellow Wall Banner	yellow_banner
Yellow Wool	yellow_wool	Yellow Wool	Identical
Zombie Head	zombie_head	Zombie Head	Identical
Zombie Wall Head	zombie_wall_head	Zombie Wall Head	zombie_head
Pearlescent Froglight	pearlescent_froglight	Pearlescent Froglight	Identical
Verdant Froglight	verdant_froglight	Verdant Froglight	Identical
Ochre Froglight	ochre_froglight	Ochre Froglight	Identical
Frogspawn	frogspawn	Frogspawn	Identical
Mangrove Button	mangrove_button	Mangrove Button	Identical
Mangrove Door	mangrove_door	Mangrove Door	Identical
Mangrove Fence	mangrove_fence	Mangrove Fence	Identical
Mangrove Fence Gate	mangrove_fence_gate	Mangrove Fence Gate	Identical
Mangrove Leaves	mangrove_leaves	Mangrove Leaves	Identical
Mangrove Log	mangrove_log	Mangrove Log	Identical
Mangrove Planks	mangrove_planks	Mangrove Planks	Identical
Mangrove Pressure Plate	mangrove_pressure_plate	Mangrove Pressure Plate	Identical
Mangrove Propagule	mangrove_propagule	Mangrove Propagule	Identical
Mangrove Roots	mangrove_roots	Mangrove Roots	Identical
Mangrove Sign	mangrove_sign	Mangrove Sign	Identical
Mangrove Slab	mangrove_slab	Mangrove Slab	Identical
Mangrove Stairs	mangrove_stairs	Mangrove Stairs	Identical
Mangrove Trapdoor	mangrove_trapdoor	Mangrove Trapdoor	Identical
Mangrove Wall Sign	mangrove_wall_sign	Mangrove Wall Sign	mangrove_sign
Mangrove Wood	mangrove_wood	Mangrove Wood	Identical
Mud	mud	Mud	Identical
Mud Brick Slab	mud_brick_slab	Mud Brick Slab	Identical
Mud Brick Stairs	mud_brick_stairs	Mud Brick Stairs	Identical
Mud Brick Wall	mud_brick_wall	Mud Brick Wall	Identical
Mud Bricks	mud_bricks	Mud Bricks	Identical
Muddy Mangrove Roots	muddy_mangrove_roots	Muddy Mangrove Roots	Identical
Packed Mud	packed_mud	Packed Mud	Identical
Reinforced Deepslate	reinforced_deepslate	Reinforced Deepslate	Identical
Sculk	sculk	Sculk	Identical
Sculk Catalyst	sculk_catalyst	Sculk Catalyst	Identical
Sculk Shrieker	sculk_shrieker	Sculk Shrieker	Identical
Sculk Vein	sculk_vein	Sculk Vein	Identical
Stripped Mangrove Log	stripped_mangrove_log	Stripped Mangrove Log	Identical
Stripped Mangrove Wood	stripped_mangrove_wood	Stripped Mangrove Wood	Identical
Oak Hanging Sign	oak_hanging_sign	Oak Hanging Sign	Identical
Oak Wall Hanging Sign	oak_wall_hanging_sign	Oak Wall Hanging Sign	oak_hanging_sign
Spruce Hanging Sign	spruce_hanging_sign	Spruce Hanging Sign	Identical
Spruce Wall Hanging Sign	spruce_wall_hanging_sign	Spruce Wall Hanging Sign	spruce_hanging_sign
Birch Hanging Sign	birch_hanging_sign	Birch Hanging Sign	Identical
Birch Wall Hanging Sign	birch_wall_hanging_sign	Birch Wall Hanging Sign	birch_hanging_sign
Jungle Hanging Sign	jungle_hanging_sign	Jungle Hanging Sign	Identical
Jungle Wall Hanging Sign	jungle_wall_hanging_sign	Jungle Wall Hanging Sign	jungle_hanging_sign
Acacia Hanging Sign	acacia_hanging_sign	Acacia Hanging Sign	Identical
Acacia Wall Hanging Sign	acacia_wall_hanging_sign	Acacia Wall Hanging Sign	acacia_hanging_sign
Dark Oak Hanging Sign	dark_oak_hanging_sign	Dark Oak Hanging Sign	Identical
Dark Oak Wall Hanging Sign	dark_oak_wall_hanging_sign	Dark Oak Wall Hanging Sign	dark_oak_hanging_sign
Mangrove Hanging Sign	mangrove_hanging_sign	Mangrove Hanging Sign	Identical
Mangrove Wall Hanging Sign	mangrove_wall_hanging_sign	Mangrove Wall Hanging Sign	mangrove_hanging_sign
Bamboo Hanging Sign	bamboo_hanging_sign	Bamboo Hanging Sign	Identical
Bamboo Wall Hanging Sign	bamboo_wall_hanging_sign	Bamboo Wall Hanging Sign	bamboo_hanging_sign
Cherry Hanging Sign	cherry_hanging_sign	Cherry Hanging Sign	Identical
Cherry Wall Hanging Sign	cherry_wall_hanging_sign	Cherry Wall Hanging Sign	cherry_hanging_sign
Crimson Hanging Sign	crimson_hanging_sign	Crimson Hanging Sign	Identical
Crimson Wall Hanging Sign	crimson_wall_hanging_sign	Crimson Wall Hanging Sign	crimson_hanging_sign
Warped Hanging Sign	warped_hanging_sign	Warped Hanging Sign	Identical
Warped Wall Hanging Sign	warped_wall_hanging_sign	Warped Wall Hanging Sign	warped_hanging_sign
Calibrated Sculk Sensor	calibrated_sculk_sensor	Calibrated Sculk Sensor	Identical
Block of Bamboo	bamboo_block	Block of Bamboo	Identical
Block of Stripped Bamboo	stripped_bamboo_block	Block of Stripped Bamboo	Identical
Cherry Leaves	cherry_leaves	Cherry Leaves	Identical
Cherry Sapling	cherry_sapling	Cherry Sapling	Identical
Chiseled Bookshelf	chiseled_bookshelf	Chiseled Bookshelf	Identical
Piglin Head	piglin_head	Piglin Head	Identical
Piglin Wall Head	piglin_wall_head	Piglin Wall Head	piglin_head
Pink Petals	pink_petals	Pink Petals	Identical
Pitcher Plant	pitcher_plant	Pitcher Plant	Identical
Sniffer Egg	sniffer_egg	Sniffer Egg	Identical
Suspicious Sand	suspicious_sand	Suspicious Sand	Identical
Suspicious Gravel	suspicious_gravel	Suspicious Gravel	Identical
Torchflower	torchflower	Torchflower	Identical
Torchflower Crop	torchflower_crop	Torchflower Crop	torchflower_seeds
Bamboo Mosaic	bamboo_mosaic	Bamboo Mosaic	Identical
Bamboo Stairs	bamboo_stairs	Bamboo Stairs	Identical
Cherry Stairs	cherry_stairs	Cherry Stairs	Identical
Bamboo Mosaic Stairs	bamboo_mosaic_stairs	Bamboo Mosaic	Identical
Bamboo Slab	bamboo_slab	Bamboo Slab	Identical
Cherry Slab	cherry_slab	Cherry Slab	Identical
Bamboo Mosaic Slab	bamboo_mosaic_slab	Bamboo Mosaic Slab	Identical
Bamboo Planks	bamboo_planks	Bamboo Planks	Identical
Cherry Planks	cherry_planks	Cherry Planks	Identical
Bamboo Button	bamboo_button	Bamboo Button	Identical
Cherry Button	cherry_button	Cherry Button	Identical
Bamboo Door	bamboo_door	Bamboo Door	Identical
Cherry Door	cherry_door	Cherry Door	Identical
Bamboo Fence	bamboo_fence	Bamboo Fence	Identical
Cherry Fence	cherry_fence	Cherry Fence	Identical
Bamboo Fence Gate	bamboo_fence_gate	Bamboo Fence Gate	Identical
Cherry Fence Gate	cherry_fence_gate	Cherry Fence Gate	Identical
Bamboo Pressure Plate	bamboo_pressure_plate	Bamboo Pressure Plate	Identical
Cherry Pressure Plate	cherry_pressure_plate	Cherry Pressure Plate	Identical
Bamboo Sign	bamboo_sign	Bamboo Sign	Identical
Bamboo Wall Sign	bamboo_wall_sign	Bamboo Wall Sign	bamboo_sign
Cherry Sign	cherry_sign	Cherry Sign	Identical
Cherry Wall Sign	cherry_wall_sign	Cherry Wall Sign	cherry_sign
Bamboo Trapdoor	bamboo_trapdoor	Bamboo Trapdoor	Identical
Cherry Trapdoor	cherry_trapdoor	Cherry Trapdoor	Identical
Potted Mangrove Propagule	potted_mangrove_propagule	Potted Mangrove Propagule	mangrove_propagule
Potted Torchflower	potted_torchflower	Potted Torchflower	torchflower
Potted Cherry Sapling	potted_cherry_sapling	Potted Cherry Sapling	cherry_sapling
